0 3
##################
# Rage->"%"*****@#
#    #*## ## ### #
#  & #  #    #   #
#    ##%#  # ### #
# Meal->"*"*****@#
##################
Level_0