0 3
###############################
#                 #    @     %#
#    # #### ###      ### ###  #
#    #           ##         # #
#  & # # #### #* #   #   #@   #
#    #           ##         # #
#    # #### ###      ### ###  #
#                 #    @     %#
###############################
Level 2